"filename", "language", "CMake", "CMake Cache", "comment", "blank", "total"
"/home/yijie/Data-Structure/FinalProject/build/CMakeCache.txt", "CMake Cache", 0, 302, 0, 65, 367
"/home/yijie/Data-Structure/FinalProject/build/CMakeFiles/3.16.3/CMakeCCompiler.cmake", "CMake", 60, 0, 0, 17, 77
"/home/yijie/Data-Structure/FinalProject/build/CMakeFiles/3.16.3/CMakeCXXCompiler.cmake", "CMake", 70, 0, 0, 19, 89
"/home/yijie/Data-Structure/FinalProject/build/CMakeFiles/3.16.3/CMakeSystem.cmake", "CMake", 10, 0, 0, 6, 16
"/home/yijie/Data-Structure/FinalProject/build/CMakeFiles/CMakeDirectoryInformation.cmake", "CMake", 12, 0, 0, 5, 17
"/home/yijie/Data-Structure/FinalProject/build/CMakeFiles/Makefile.cmake", "CMake", 47, 0, 0, 6, 53
"/home/yijie/Data-Structure/FinalProject/build/CMakeFiles/main.dir/DependInfo.cmake", "CMake", 18, 0, 0, 4, 22
"/home/yijie/Data-Structure/FinalProject/build/CMakeFiles/main.dir/cmake_clean.cmake", "CMake", 9, 0, 0, 2, 11
"/home/yijie/Data-Structure/FinalProject/build/CMakeFiles/test_adjacency.dir/DependInfo.cmake", "CMake", 19, 0, 0, 4, 23
"/home/yijie/Data-Structure/FinalProject/build/CMakeFiles/test_adjacency.dir/cmake_clean.cmake", "CMake", 10, 0, 0, 2, 12
"/home/yijie/Data-Structure/FinalProject/build/CMakeFiles/test_edges.dir/DependInfo.cmake", "CMake", 20, 0, 0, 4, 24
"/home/yijie/Data-Structure/FinalProject/build/CMakeFiles/test_edges.dir/cmake_clean.cmake", "CMake", 11, 0, 0, 2, 13
"/home/yijie/Data-Structure/FinalProject/build/CMakeFiles/test_minHeap.dir/DependInfo.cmake", "CMake", 18, 0, 0, 4, 22
"/home/yijie/Data-Structure/FinalProject/build/CMakeFiles/test_minHeap.dir/cmake_clean.cmake", "CMake", 9, 0, 0, 2, 11
"/home/yijie/Data-Structure/FinalProject/build/cmake_install.cmake", "CMake", 42, 0, 0, 8, 50
"Total", "-", 355, 302, 0, 150, 807